s
#######
#@....#
#..$..#
#..O..#
#..$..#
#..O..#
#######
s
############..
#OO..#.....###
#OO..#.$..$..#
#OO..#$####..#
#OO....@.##..#
#OO..#.#..$.##
######.##$.$.#
..#.$..$.$.$.#
..#....#.....#
..############
s
........########.
........#.....@#.
........#.$#$.##.
........#.$..$#..
........##$.$.#..
#########.$.#.###
#OOOO..##.$..$..#
##OOO....$..$...#
#OOOO..##########
########.........
e